1 1 1 1 1 1 1 1 1 1 1 1 1 1 1 1
1 0 0 C 0 1 0 1 0 C 0 0 0 0 0 1
1 0 0 0 0 0 0 0 0 1 0 0 0 0 0 1
1 1 0 0 G 0 0 1 0 0 0 1 0 0 0 1
1 P 0 0 1 1 0 0 0 0 0 1 0 0 0 1
1 1 0 1 1 1 1 0 0 0 0 1 0 0 0 1
1 0 C 0 0 1 1 1 0 1 0 1 1 0 0 1
1 0 0 0 1 1 1 1 0 1 0 1 1 0 0 1
1 0 0 0 1 1 1 1 0 1 0 1 1 0 0 1
1 0 0 0 1 1 0 0 0 1 0 1 C 0 0 1
1 E 1 0 1 0 0 1 0 1 0 1 0 0 0 1
1 0 1 0 1 C 0 1 0 1 0 1 1 1 0 1
1 0 C 0 1 1 1 1 C 1 0 1 1 1 C 1
1 1 1 1 1 1 1 1 1 1 1 1 1 1 1 1
