1 1 1 1
1 P C 1
1 0 0 1
1 E 0 1
1 1 1 1